%%%%%%%%%%%%%%%%%%%%%%%%%%%%%%%%%%%%%
%%%%%.    %%%%%%%%%%%   %%%%%%%%%%%%%
%%%%%%    %%%%%%%%%    %%%%%%%%%%%%%%
%%%%%%%    %%%%%%%    %%%%%%%%%%%%%%%
%%%%%%%%    %%%%%    %%%%%%%%%%%%%%%%
%%%%%%%%%    %%%    %%%%%%%%%%%%%%%%%
%%%%%%%%%%         %%%%%%%%%%%%%%%%%%
%%%%%%%%%%%%%% %%%%%%%%%%%%%%%%%%%%%%
%%%%%%%%%%%%%% %%%%%%%%%%%%%%%%%%%%%%
%%%%%%%%%%%%%% %%%%%%%%%%%%%%%%%%%%%%
%%%%%%%%             %%%%%%%%%%%%%%%%
%%%%%%      %%%%%     %%%%%%%%%%%%%%%
%%%%%       %%%%%       %%%%%%%%%%%%%
%%%%%                   %%%%%%%%%%%%%
%%%%%     %%%%%%%%%     %%%%%%%%%%%%%
%%%%%     %%%%%%%%%     %%%%%%%%%%%%%
%%%%%     %%%%%%%%%     %%%%%%%%%%%%%
%%%%%%%%%%%%%%%%%%%%%% %%%%%%%%%%%%%%
%%%%%%%%%%%%%%%%%%%%%% %%%%%%%%%%%%%%
%%%%%%%%%%%%%%%%%%%%%% %%%%%%%%%%%%%%
%%%%%    %%%%%%%%%%%    %%%%%%%%%%%%%
%%%%%%    %%%%%%%%%    %%%%%%%%%%%%%%
%%%%%%%    %%%%%%%    %%%%%%%%%%%%%%%
%%%%%%%%    %%%%%    %%%%%%%%%%%%%%%%
%%%%%%%%%    %%%    %%%%%%%%%%%%%%%%%
%%%%%%%%%%         %%%%%%%%%%%%%%%%%%
%%%%%%%%%%%%%% %%%%%%%%%%%%%%%%%%%%%%
%%%%%%%%%%%%%% %%%%%%%%%%%%%%%%%%%%%%
%%%%%%%%%%%%%% %%%%%%%%%%%%%%%%%%%%%%
%%%%%%%%             %%%%%%%%%%%%%%%%
%%%%%%      %%%%%     %%%%%%%%%%%%%%%
%%%%%       %%%%%       %%%%%%%%%%%%%
%%%%%                   %%%%%%%%%%%%%
%%%%%     %%%%%%%%%     %%%%%%%%%%%%%
%%%%%     %%%%%%%%%     %%%%%%%%%%%%%
%%%%%     %%%%%%%%%p    %%%%%%%%%%%%%
%%%%%%%%%%%%%%%%%%%%%%%%%%%%%%%%%%%%%
